WWWWWWWWWW
WS   M   W
WWWWWWWW W
W   W    W
WMWMWMWMWW
W W WTW  W
W   MM   W
W TWWWWWWW
W     TMEW
WWWWWWWWWW
