WWWWWWWWWW
WS M     W
WWWWWWWWMW
W     W  W
WMWMWMWMWW
W   WTW  W
W M      W
W TWWWWWWW
W   M   EW
WWWWWWWWWW
