WWWWWWWWWW
WE   TM  W
WWWWWWWWMW
WT    W  W
WMWMWMWMWW
W W W W  W
W W   MT W
W TWWWWWWW
WM  M   SW
WWWWWWWWWW