WWWWWWWWWW
WE   M   W
WWWWWWW WW
W W   W  W
WM M M MWW
W W WT   W
W     M TW
W SWWWWWWW
W   M   SW
WWWWWWWWWW
