WWWWWWWWWW
WE   M  TW
WWWMWWWMWW
W        W
WMWMWMWMWW
W W WTW  W
W W      W
W TWWWWWWW
W     M SW
WWWWWWWWWW
