WWWWWWWWWW
WE     M W
WWWWWWWW W
W   W    W
WMWMWMWMWW
W W WT   W
W W   W TW
W TWWWWWWW
W   M   SW
WWWWWWWWWW
