WWWWWWWWWW
WS   MT  W
WWWWWWWW W
W   W    W
WMWMWMWMWW
W W WTW  W
W W     TW
W TWWWWWWW
W   M   EW
WWWWWWWWWW