WWWWWWWWWW
WS M     W
WWWWWWWW W
WT    W  W
WM  MW MWW
W W WT   W
W W     TW
W TWWWWWWW
W   M   EW
WWWWWWWWWW
