WWWWWWWWWW
WS   M   W
WWWWWWWWMW
W     W  W
WMWMWMWMWW
W   WT   W
W M     TW
W TWWWWWWW
W   M   EW
WWWWWWWWWW
