WWWWWWWWWW
WS   M   W
WWWWWWWWMW
WT  W    W
WM M M MWW
W W WT   W
W  T  M  W
W TWWWWWWW
W   M   EW
WWWWWWWWWW
